000000000000000000000
011555550101110111010
010500050555000001010
010555055505550111110
000005010000050000010
055505010555055501010
050505000505000501010
050555055505550401110
050000050000050001000
055511055503055501010
010500000505000501010
010501111555110501110
000500100000000500010
055510110555055511010
050000000505050001010
050555550505550111010
050500050501000000010
050555055501111111010
050005000000000100010
055555111111011111110
000000000000000000000